NO ./textures/north.xpm
SO ./textures/south.xpm
WE ./textures/west.xpm
EA ./textures/east.xpm

F 220,100,0
C 120,120,255

111111111111111111
100001111111111111
10N000000000000001
111111111111111111